{
  "playerPos": [8, 2],
  "board": [
    ["#", "#", "#", "#", "#", "#", "#", "#", "#", "#", "#", "#", "#", "#", "#", "#"],
    ["#", ".", ".", ".", ".", ".", ".", ".", ".", ".", ".", "L", ".", ".", ".", "#"],
    ["#", ".", ".", ".", ".", ".", ".", "#", "#", "#", "#", "#", "#", "#", "#", "#"],
    ["#", ".", ".", ".", ".", ".", ".", ".", ".", ".", ".", ".", ".", "#", "G", "#"],
    ["#", ".", ".", ".", ".", ".", ".", ".", ".", ".", ".", ".", ".", ".", ".", "#"],
    ["#", ".", ".", ".", ".", ".", ".", ".", ".", ".", ".", ".", ".", ".", ".", "#"],
    ["#", ".", ".", ".", ".", ".", "B", ".", ".", ".", ".", ".", ".", ".", ".", "#"],
    ["#", ".", ".", ".", "#", "#", "W", "#", "#", ".", ".", ".", ".", ".", ".", "#"],
    ["#", ".", ".", ".", "#", "W", "W", "W", "#", ".", ".", ".", ".", ".", ".", "#"],
    ["#", ".", ".", ".", "#", "W", "W", "W", "#", ".", ".", ".", ".", ".", ".", "#"],
    ["#", "#", "#", "#", "#", "#", "#", "#", "#", "#", "#", "#", "#", "#", "#", "#"]
  ]
}