{
  "playerPos": [ 4, 7 ],
  "board": [
    [ "#", "#", "#", "#", "#", "#", "#", "#", "#", "#", "#", "#", "#", "#", "#", "#" ],
    [ "#", ".", ".", ".", ".", ".", ".", ".", ".", ".", ".", ".", ".", "#", "#", "#" ],
    [ "#", ".", "#", "B", "#", "#", "#", "#", "#", "#", "#", ".", ".", ".", ".", "#" ],
    [ "#", ".", "#", ".", ".", "#", ".", ".", ".", ".", "#", ".", ".", ".", ".", "#" ],
    [ "#", ".", "#", ".", ".", "#", ".", ".", ".", ".", "#", ".", ".", ".", ".", "#" ],
    [ "#", ".", "#", "G", ".", "#", ".", ".", ".", ".", "#", ".", ".", ".", ".", "#" ],
    [ "#", ".", "#", "#", "#", "#", ".", "B", ".", ".", "#", "#", "#", "B", "#", "#" ],
    [ "#", ".", "#", "L", ".", "#", ".", ".", ".", ".", ".", ".", ".", ".", ".", "#" ],
    [ "#", ".", "#", "#", ".", "#", "#", "#", "#", "#", "#", "#", "#", "#", ".", "#" ],
    [ "#", ".", ".", ".", ".", ".", ".", ".", ".", ".", ".", ".", ".", "#", "L", "#" ],
    [ "#", "#", "#", "#", "#", "#", "#", "#", "#", "#", "#", "#", "#", "#", "#", "#" ]
  ]
}